NO src/textures/akali.xpm
SO src/textures/project_kat.xpm
WE src/textures/katarina.xpm
EA src/textures/kat_battle_queen.xpm

C  10, 111, 101
F  210, 22, 3

        1111111111111111111111111
        100000000011N000000000001
        1000000000110000000000001
        1011000001110000001000001
        1001000001000000000000001
111111111011000001110000000000001
100000000011000001110111111111111
11110111111111011100000010001
11110111111111011101010010001
11000000110101011100000000001
10000000000000001100000010001
10000000000000001101010010001
110000011101010111110111100111
11110111 1110101 101111010001
11111111 1111111 111111111111
