NO src/textures/d-evil-s.xpm
SO src/textures/d-evil-s.xpm
WE src/textures/d-evil-s.xpm
EA src/textures/d-evil-s.xpm

F  0, 0, 0
C  0, 0, 0

 1111111111111         1111111111111         1111111111111
11N011111111111       110011111111111       110011111111111
10001                 10001                 10001
10001                 10001                 10001
10001                 10001                 10001
10001111111111        10001111111111        10001111111111
100000000000011       100000000000011       100000000000011
100011111110001       100011111110001       100011111110001
10001     10001       10001     10001       10001     10001
100011111110001       100011111110001       100011111110001
110000000000011       110000000000011       110000000000011
 1111111111111         1111111111111         1111111111111
